X X X X X X X X
X _ # _ - _ # X
X _ _ X - - _ X
X X X X _ _ _ X
X _ _ _ _ _ H X
X _ O _ _ X X X
X _ _ - - _ _ X
X X X X X X X X